-13
13
-6
5
000000000000000000000000000
000000000000000000000000000
000000000000010011111110000
000000000000000011111110000
000000000000000011111110000
000000000010000011111110000
000000000000000011111110000
000000000000000011111110000
000000000000000011111110000
000000000000010000000000000
000000000000000000000000000
000000000000000000000000000
