-13
13
-6
5
111111111111111111111111110
100000000000000000000000011
100000000000010011111110011
100000000000000011111110010
100000000000000011111110010
100000000010000011111110010
100000000000000011111110010
100000000000000011111110010
100000000000000011111110010
100000000000010000000000010
111111111111111111111111110
000000000000000000000000000
