-3
10
-4
4
00010011111110
00000011111110
00000011111110
10000011111110
00000011111110
00000011111110
00000011111110
00010000000000
00000000000000
